Grippe=Doliprane
Migraine=Ibuprofène
Allergie=Antihistaminique
Bronchite=Amoxicilline
Covid léger=Repos et paracétamol
Pneumonie=Antibiotiques (prescription médicale)
Dermatite=Crème corticostéroïde
Intoxication alimentaire=Hydratation et Smecta
Gastro-entérite=Spasfon et réhydratation
Asthme=Ventoline
Grippe saisonnière=Paracétamol
Infection digestive=Probiotiques + réhydratation
Rhume=Paracétamol + décongestionnant
Mononucléose=Repos + paracétamol
Conjonctivite allergique=Collyre antihistaminique
Angine=Antalgiques, voire antibiotiques
Otite=Paracétamol ou antibiotiques
Rhino-pharyngite=Spray nasal, repos
Sinusite=Corticoïdes nasaux
Méningite=Urgence médicale
Conjonctivite virale=Lavage oculaire
Hépatite A=Repos, régime alimentaire
Appendicite=Chirurgie
Rougeole=Repos, paracétamol
Varicelle=Antiprurigineux
Grippe intestinale=Réhydratation orale
Covid sévère=Consultation médicale urgente
Infection urinaire=Furadantine
Malaria=Antipaludéens
Scarlatine=Antibiotiques
Lupus érythémateux disséminé=Suivi spécialisé et immunosuppresseurs
Hépatite virale=Repos + surveillance hépatique
Mal des transports=Dimenhydrinate
Angine bactérienne=Antibiotiques
Coqueluche=Antibiotiques (macrolides)
Méningo-encéphalite=Antiviraux ou antibiotiques
Anémie=Fer + vitamine B12
Dengue=Paracétamol + hydratation
